NO ./textures/greystone.xpm
SO ./textures/colorstone.xpm
WE ./textures/wood.xpm
EA ./textures/redbrick.xpm

F 55,118,83
C 135,206,235

1111111111111111111111111
1000000000110000000000001
1011000001110000000000001
1001000000000000000000001
1111111110110000011100001
1000000000110000011101111
1111011100011101110010001
1111011100011101010010001
1100110101011100000010001
1000000000001100000010001
1000000000001101010010001
1100010101111101111000111
11110111110101011110100W1
1111111111111111111111111
