NO ./textures/bluestone.xpm
SO ./textures/eagle.xpm
WE ./textures/purplestone.xpm
EA ./textures/mossy.xpm

F 55,118,83
C 135,206,235

1111111111111111111111111
1000000000110000000000001
1011000001110000000000001
1001000000000000000000001
1111111110110000011100001
1000000000110000011101111
1111011100011101110010001
1111011100011101010010001
11001101010111000N0010001
1000000000001100000010001
1000000000001101010010001
11000101011111011110N0111
1111011111010101111010001
1111111111111111111111111